1, 1, 1, 1, 1, 1, 1, 1, 4, 3, 5, 1
1, 1, 1, 1, 1, 1, 1, 1, 4, 3, 5, 1
1, 1, 1, 1, 1, 1, 1, 1, 4, 3, 5, 1
1, 1, 1, 1, 1, 1, 1, 1, 4, 3, 5, 1
1, 1, 1, 1, 1, 1, 1, 1, 4, 3, 5, 1
1, 1, 1, 1, 1, 1, 1, 1, 4, 3, 5, 1
1, 1, 1, 1, 1, 1, 2, 2, 2, 2, 2, 2
1, 1, 1, 1, 1, 1, 2, 1, 4, 3, 5, 1
1, 1, 1, 1, 1, 1, 2, 1, 4, 3, 5, 1
1, 1, 1, 1, 1, 1, 2, 1, 4, 3, 5, 1
1, 1, 1, 1, 1, 1, 2, 1, 4, 3, 5, 1
1, 1, 1, 1, 1, 1, 2, 1, 4, 3, 5, 1